FFFFFFFFFFFF
F....L     F
F.  .      F
F.  .....  F
F. FFFFF.  F
F. R...F.  F
F.  . .F.  F
F.  . .F.  F
F. .. .F.  F
F. .R .F.  F
F..+. .F.  F
F  .. .F.  F
F  .. .F.  F
FFFFF .F.  F
FS    .F.  F
F.L   .F.  F
F......F.  F
F..    F. GF
F..    F...F
FFFFFFFFFFFF