FFFFFFFFFFFFFFFF
F       F      F
F       F      F
F F    F....L  F
F F......  .   F
F...       .   F
F.  F      .   F
F.  F      .   F
F.  F      .   F
F.       F .   F
F.      RF .   F
F........F .   F
FS      .F .   F
F.      .F . G F
F........F ... F
FFFFFFFFFFFFFFFF