FFFFFFFFFFFFFFF
FG........... F
F..         . F
FFFFFFFFF  L..F
F          ...F
F          .  F
F       ....  F
FS     ..FFFFFF
F.......FF     
FFFFFFFFF      